################
#              #
# ############ ##
#               #
# ####### # # ###
# #     # # #   #
# # ### # # ### #
# #   # # #   # #
# ### # # ### # #
# #k  # #   # # #
# ##### ### # # #
#           # # #
############# # #
#             # #
#           l  ##
##############e##